NO textures/test/north.xpm
SO textures/test/south.xpm
WE textures/test/west.xpm
EA textures/test/east.xpm


DO DSFF
F dsds
C ds

11111
10101
11N0D
10101
10001
10001
11001
10001
10001
10001
10001
10001
11111
