
NO 	textures/soinc.png
SO textures/soinc.png

DO textures/soinc.png

WE textures/soinc.png
C  textures/soinc.png

F 				textures/soinc.png

EA 					textures/soinc.png

1111111
11111111111
100000101
10000DN11111
100000001
11111111
