NO textures/rust/rust_wall.png
SO textures/rust/rust_wall.png
WE textures/rust/rust_wall.png
EA textures/rust/rust_wall.png

DO textures/rust/rust_door.png

C textures/rust/rust_floor.png
F textures/rust/rust_foundation.png

  11
 1001                                   1111
 1001111111                            100001
 1000000000111111     1111      1111111100001
 10000000001111111111111111111110000000000001
 10000000001000010000011101000010000110000001
10000100000D0000000000000010000100000000000011
10000000000101000000000000D0000D000000000000001
10000000000111111111100000100001001111111000001
100000000001        111011111111101     1000001
111D11101001        100000100000001     100011
  101 100001  111111100001100000001     10001
  101  1111  100000000000010111111      10001
  10111      1000000000000101     11111110001
  100001111111101111100000001    10000000000111
 1000000000000001    10000001    100000000000001
 100000000000001     10000001    11D111000100001
  1111100111111      10000001    100011000100001
    11100111         100000011111100011000111111
  110000000011      10000000000001000110001
 10000000000001     100001111000011D111111
 10000000000001      11001111000000001
 10000000000001        101111000000001
 1000000001011  111    101111000000001
 100000111111  10001   10111100000111
 1000000000001100001   100000000001
10000000000000000001111111110000001
100000000000000000000N0000000000001
10000000000000000000000000000000001
1111000000001111100111111000001111
    11111111     11      11111