
	             NO 	textures/brick.png
                  SO textures/brick.png

          DO textures/brick.png

WE textures/brick.png

       F 				textures/floor.png
   C   textures/floor.png

  					  EA 			textures/brick.png

11111111111111111111111111111111111111111111111111111111111111111111111111
10000000000000000000000000000000000000000000000000000000000000000000000001
10E00000000000D0000D00D000000000000000000000000000000000000000000000000D01
10000000000000000000000000000000000000000000000000000000000000000000000001
11111111111111111111111111111111111111111111111111111111111111111111111111