




                 NO 	dsds
      SO            ./path_to_the_south_texture




          DO fjhshjfsjhf


WE SDDS

       F 				./path_to_the_
   C   ./path_to_the_ceilling_texture
  					  EA 			./path_to_the_east_texture




          1111111111111111111111111
          1000000000000000000000001
          1011000001110000000000001
          1001000000100000000000011
111111111111000001110000000000001
100000000011000001110111111111111
11110111111111011100000000001
11110111111111011101010010001
11000000110101011100000010001
10000000000000000000000010001
10000000000000001101010010001
11000001110101011101111110S0111
11110111 1110101 101111010001
11111111 1111111 111111111111
1
