NO textures/rust/rust_wall.png
SO textures/rust/rust_wall.png
WE textures/rust/rust_wall.png
EA textures/rust/rust_wall.png

DO textures/rust/rust_door.png

C textures/rust/rust_floor.png
F textures/rust/rust_foundation.png

  11
 1001111
100001001
10E000D11
100000001
11111111